acetaminophen (Tylenol/APAP)	pain
acetaminophen/codeine (Tylenol #3)	pain
albuterol (Proair, Proventil)	breathing difficulty 
alendronate (Fosamax)	osteoporosis 
allopurinol	gout
alprazolam (Xanax)	anxiety
aluminum hydroxide, magnesium hydroxide (Maalox)	heartburn
amitriptyline (Elavil)	depression
amlodipine (Norvasc)	HTN
amoxicillin (Amoxil)	infection
aripiprazole (Abilify)	sleep
artificial tears 	dry eyes
ascorbic acid (vitamin C)	vitamin
aspirin + ER dipyridamole (Aggrenox)	blood clots
aspirin/acetylsalicylic acid (ASA)	pain
atenolol (Tenormin)	HTN
atorvastatin (Lipitor)	high cholestrol
baclofen	muscle tension
betaxolol (Betoptic)	glaucoma
bimatoprost (Lumigan)	glaucoma
bisacodyl (Dulcolax)	constipation
bismuth subsalicylate (Pepto-Bismol)	diarrhea
brimonidine (Alphagan)	glaucoma
budesonide + formoterol (Symbicort)	asthma
budesonide (Pulmicort)	breathing difficulty 
bumetanide	HTN
buspirone (Buspar)	anxiety
calcitonin (Miacalcin, Fortical)	osteoporosis 
calcium carbonate (Tums)	nausea
calcium (Os-cal)	vitamin
captopril (Capoten)	HTN
carbamazepine (Tegretol)	convulsions
cefdinir	infection
celecoxib (Celebrex)	pain
cephalexin (Keflex)	infection
cetirizine (Zyrtec)	allergies
cholestyramine (Questran)	high cholestrol
cimetidine (Tagamet)	stomach ulcer
citalopram (Celexa)	depression
clindamycin (Cleocin)	infection
clonazepam (Klonopin)	convulsions
clopidogrel (Plavix)	high cholestrol
codeine	cough
conjugated estrogen (Premarin)	hormone
cortisone	inflammation 
cyanocobalamin (Vitamin B12)	vitamin
cyclobenzaprine	muscle tension
dexamethasone (Decadron)	inflammation 
diazepam (Valium)	anxiety
digoxin (Lanoxin)	heart failure
diltiazen (Cardizem)	HTN
diphenhydramine (Benadryl)	allergies
divalproex sodium (Depakote)	convulsions
docusate sodium (Colace)	constipation
donepezil (Aricept)	dementia
duloxetine	depression
enalapril (Vasotec)	HTN
enoxaparin (Lovenox)	blood clots
escitalopram (Lexapro)	depression
esomeprazole (Nexium)	heartburn
estradiol	hormone
ezetimibe (Zetia)	high cholestrol
famotidine (Pepcid)	heartburn
fentanyl transdermal (Duragesic)	pain
ferrous sulfate (Feosol)	anemia
fexofenadine (Allegra)	allergies
finasteride (Proscar)	hormone
fluticasone + salmeterol (Advair)	asthma
fluticasone (Flovent)	breathing difficulty 
folic acid	vitamin
furosemide (Lasix)	HTN
gabapentin (Neurontin)	convulsions
gemfibrozil (Lopid)	high cholestrol
gentamicin	eye infection
glimepiride (Amaryl)	diabetes
glipizide (Glucotrol)	diabetes
glucogan	diabetes
glyburide (DiaBeta)	diabetes
guaifenesin (Mucinex)	cough
haloperidol (Haldol)	psychosis
heparin	blood clots
humulin (insulin)	diabetes
hydralazine	HTN
hydrochlorothiazide / HCTZ	HTN
hydrocodone/acetaminophen (Lortab, Norco, Vicodin)	pain
hydrocortisone (Solu-Cortef)	inflammation 
hydroxyzine (Vistaril)	anxiety
ibuprofen (Motrin, Advil)	pain
insulin glargine (insulin)	diabetes
iodine, iodide	overactive thyroid 
ipratropium + albuterol (Duoneb)	breathing difficulty 
ipratropium (Atrovent)	breathing difficulty 
iron polysaccharide (Niferex)	anemia
isosorbide (Imdur, Isordil)	angina
ketorolac (Toradol)	pain
labetalol	HTN
lactulose	constipation
lamotrigine (Lamictal)	convulsions
lansoprazole (Prevacid)	heartburn
latanoprost (Xalatan)	glaucoma
levalbuterol (Xopenex)	breathing difficulty 
levodopa + carbidopa (Sinemet)	parkinson's
levofloxacin (Levaquin)	infection
levothyroxine (Levoxyl, Synthroid)	hormone
lisinopril (Zestril)	HTN
loperamide (Imodium)	diarrhea
loratadine (Claritin)	allergies
lorazepam (Antivan)	anxiety
losartan (Cozaar)	HTN
magnesium hydroxide (Milk of Mag)	constipation
megestrol (Megace)	hormone
meloxicam (Mobic)	pain
memantine (Namenda)	dementia
meperidine (Demerol)	pain
mesalamine (Asacol)	pain
metformin (Glucophage)	diabetes
methotrexate	cancer
methylprednisolone (Solu-medrol)	inflammation 
metoclopramide (Reglan)	nasea
metolazone (Zaroxolyn)	HTN
metoprolol (Lopressor, Toprol-XL)	HTN
mirtazapine (Remeron)	depression
montelukast (Singulair)	breathing difficulty 
morphine (MS)	pain
multi-vitamin with mineral (Ocuvite)	vitamin
mupirocin (Bactroban)	infection
naproxen	pain
nitrofurantoin (Macrodantin/Macrobid)	UTI
nitroglycerine	angina
nitro-patch	angina
nitrostat	angina
novolin (insulin)	diabetes
nystatin (Mycostatin)	fungal infection
ofloxacin	eye infection
olmesartan (Benicar)	HTN
omeprazole (Prilosec)	heartburn
ondansetron (Zofran)	nausea
oxybutin (Ditropan XL)	overactive bladder
oxycodone (Oxycontin)	pain
pantoprazole (Protonix)	heartburn
paroxetine (Paxil)	depression
phenobarbital	convulsions
phenytoin (Dilantin)	convulsions
pilocarpine	glaucoma
pioglitazone (Actos)	diabetes
polyethylene glycol (Miralax)	constipation
potassium chloride (Klor-Con, K-Tab, K-Dur)	vitamin
prednisolone	inflammation 
prednisone	inflammation 
prochlorperazine	nausea
promethazine	allergies
pseudoephedrine (Sudafed)	congestion
psyllium (Metamucil)	constipation
quetiapine (Seroquel)	psychosis
quinapril (Accupril)	HTN
ralozifene (Evista)	osteoporosis 
ramapril (Altace)	HTN
ranitidine (Zantac)	heartburn
risedronate (Actonel)	osteoporosis 
risperidone (Risperdal)	psychosis
rosuvastatin (Crestor)	high cholestrol
sennosides (Senokot, Ex-Lax, Senna)	constipation
sertraline (Zoloft)	depression
simethicone (Gas-x/ Mylanta)	gas
simvastatin (Zocor)	high cholestrol
sitagliptin (Januvia)	diabetes
spironolactone (Aldactone)	HTN
sulfamethoxazole-trimethoprim (Bacterium/Septra)	infection
tamoxifen	cancer
tamsulosin (Flomax)	overactive bladder
temazepam (Restoril)	sleep
terazosin	HTN
timolol (Timoptic)	glaucoma
tiotropium (Spiriva)	breathing difficulty 
tolterodine (Detrol)	overactive bladder
tramadol (Ultram)	pain
travoprost (Travatan)	glaucoma
trazodone	depression
valproic acid (Depakene)	convulsions
valsartan (Diovan)	HTN
verapamil (Isoptin SR)	HTN
Vitamin E	vitamin
warfarin (Coumadin)	blood clots
zolpidem (Ambien)	sleep
cough drop	cough
protien powder	vitamin
